BBBBBBBBBBBBBBBB
BP.............B
BOOOOOOOOOO....B
B..............B
BOOOOOOOOO.....B
B..............B
B..............B
BO.OOO.OOO.OOOOB
BO.OOO.OOO.OOOOB
B...O...O..OOO.B
B...O...O..OOO.B
B...O...O......B
BBBBBBBBBBBBBBBB
BBBBBBBBBBBBBBBB