BBBBBBBBBBBBBBBB
BP.............B
BOOOOOOOOOO....B
B..TT..........B
BOOOOOOOOO.....B
B..............B
B..............B
BO.OOO.OOOTOOOOB
BO.OOO.OOOTOOOOB
BTTTO...OTTOOO.B
BTTTO...OTTOOO.B
BTTTO...OTT....B
BBBBBBBBBBBBBBBB
BBBBBBBBBBBBBBBB